## ls
$ls -ltr:  Use lsr for recursive approach. It is useful when we want a hierarchy of a folder.
This command is used to list all the files. Use lsr for recursive approach. It is useful when we want a hierarchy of a folder.

## mkdir 
To create a directory. In Hadoop dfs there is no home directory by default. So let’s first create it.

## touch: It creates an empty file

## cat: To print file contents

## copyToLocal (or) get: To copy files/folders from hdfs store to local file system
## moveFromLocal: This command will move file from local to hdfs
## cp This command is used to copy files within hdfs. Lets copy folder geeks to geeks_copied.
## rmr: This command deletes a file from HDFS recursively. It is very useful command when you want to delete a non-empty directory.
## du: It will give the size of each file in directory
## dus:: This command will give the total size of directory/file.
## stat: It will give the last modified time of directory or path. In short it will give stats of the directory or file.

Syntax History:
hadoop@ubuntudev:~$ source ~/.bashrc
hadoop@ubuntudev:~$ start-dfs.sh && start-yarn.sh
Starting namenodes on [localhost]
localhost: starting namenode, logging to /usr/local/hadoop-ecosystem/hadoop-2.9.2/logs/hadoop-hadoop-namenode-ubuntudev.out
localhost: starting datanode, logging to /usr/local/hadoop-ecosystem/hadoop-2.9.2/logs/hadoop-hadoop-datanode-ubuntudev.out
Starting secondary namenodes [0.0.0.0]
0.0.0.0: starting secondarynamenode, logging to /usr/local/hadoop-ecosystem/hadoop-2.9.2/logs/hadoop-hadoop-secondarynamenode-ubuntudev.out
starting yarn daemons
starting resourcemanager, logging to /usr/local/hadoop-ecosystem/hadoop-2.9.2/logs/yarn-hadoop-resourcemanager-ubuntudev.out
localhost: starting nodemanager, logging to /usr/local/hadoop-ecosystem/hadoop-2.9.2/logs/yarn-hadoop-nodemanager-ubuntudev.out
hadoop@ubuntudev:~$ jps
2849 SecondaryNameNode
2980 ResourceManager
3398 Jps
2487 NameNode
3116 NodeManager
2653 DataNode
hadoop@ubuntudev:~$ ls
Apps  Desktop  Documents  Downloads  eclipse  eclipse-workspace  Music  Pictures  Public  snap  Templates  Videos
hadoop@ubuntudev:~$ ls -ltr
total 48
drwxr-xr-x 2 hadoop hadoop 4096 Mar  4 08:15 Templates
drwxr-xr-x 2 hadoop hadoop 4096 Mar  4 08:15 Public
drwxr-xr-x 2 hadoop hadoop 4096 Mar  4 08:15 Downloads
drwxr-xr-x 2 hadoop hadoop 4096 Mar  4 08:15 Documents
drwxr-xr-x 2 hadoop hadoop 4096 Mar  4 08:15 Videos
drwxr-xr-x 2 hadoop hadoop 4096 Mar  4 08:15 Pictures
drwxr-xr-x 2 hadoop hadoop 4096 Mar  4 08:15 Music
drwxr-xr-x 4 hadoop hadoop 4096 Mar  4 20:35 snap
drwxrwxr-x 3 hadoop hadoop 4096 Mar 11 05:55 Apps
drwxrwxr-x 4 hadoop hadoop 4096 Mar 11 20:19 eclipse
drwxrwxr-x 4 hadoop hadoop 4096 Mar 11 20:33 eclipse-workspace
drwxr-xr-x 2 hadoop hadoop 4096 Mar 11 21:26 Desktop
hadoop@ubuntudev:~$ ls -lsr
total 48
4 drwxr-xr-x 2 hadoop hadoop 4096 Mar  4 08:15 Videos
4 drwxr-xr-x 2 hadoop hadoop 4096 Mar  4 08:15 Templates
4 drwxr-xr-x 4 hadoop hadoop 4096 Mar  4 20:35 snap
4 drwxr-xr-x 2 hadoop hadoop 4096 Mar  4 08:15 Public
4 drwxr-xr-x 2 hadoop hadoop 4096 Mar  4 08:15 Pictures
4 drwxr-xr-x 2 hadoop hadoop 4096 Mar  4 08:15 Music
4 drwxrwxr-x 4 hadoop hadoop 4096 Mar 11 20:33 eclipse-workspace
4 drwxrwxr-x 4 hadoop hadoop 4096 Mar 11 20:19 eclipse
4 drwxr-xr-x 2 hadoop hadoop 4096 Mar  4 08:15 Downloads
4 drwxr-xr-x 2 hadoop hadoop 4096 Mar  4 08:15 Documents
4 drwxr-xr-x 2 hadoop hadoop 4096 Mar 11 21:26 Desktop
4 drwxrwxr-x 3 hadoop hadoop 4096 Mar 11 05:55 Apps
hadoop@ubuntudev:~$ mkdir tempToDelete
hadoop@ubuntudev:~$ cd tempToDelete
hadoop@ubuntudev:~/tempToDelete$ -touchz temp.txt
-touchz: command not found
hadoop@ubuntudev:~/tempToDelete$ cd ..
hadoop@ubuntudev:~$ touch /tempToDelete/temp.text
touch: cannot touch '/tempToDelete/temp.text': No such file or directory
hadoop@ubuntudev:~$ cd tempTodelete
bash: cd: tempTodelete: No such file or directory
hadoop@ubuntudev:~$ cd tempToDelete
hadoop@ubuntudev:~/tempToDelete$ touch temp.txt
hadoop@ubuntudev:~/tempToDelete$ cat temp.text
cat: temp.text: No such file or directory
hadoop@ubuntudev:~/tempToDelete$ cat temp.txt
hadoop@ubuntudev:~/tempToDelete$ touch temp2.txt
hadoop@ubuntudev:~/tempToDelete$ touch temp3.txt
hadoop@ubuntudev:~/tempToDelete$ get temp.txt ../Desktop/hero

Command 'get' not found, but there are 18 similar ones.

hadoop@ubuntudev:~/tempToDelete$ copyToLocal temp.txt ../Desktop/hero
copyToLocal: command not found
hadoop@ubuntudev:~/tempToDelete$ moveFromLocal ../Desktop/temp /tempToDelete
moveFromLocal: command not found
hadoop@ubuntudev:~/tempToDelete$ cd ../Desktop
hadoop@ubuntudev:~/Desktop$ cd temp
hadoop@ubuntudev:~/Desktop/temp$ touch temp.text
hadoop@ubuntudev:~/Desktop/temp$ delete temp.text
delete: command not found
hadoop@ubuntudev:~/Desktop/temp$ del temp.text

Command 'del' not found, did you mean:

  command 'den' from snap den (1.2.0-0)
  command 'el' from deb oneliner-el (0.3.6-8)
  command 'tel' from deb orville-write (2.55-3build1)
  command 'deal' from deb deal (3.1.9-12)
  command 'wdel' from deb wput (0.6.2+git20130413-8)
  command 'hdel' from deb hfsutils (3.2.6-14)
  command 'delv' from deb bind9-dnsutils (1:9.16.1-0ubuntu2.7)
  command 'dep' from deb go-dep (0.5.4-3)
  command 'dex' from deb dex (0.8.0-2)
  command 'mdel' from deb mtools (4.0.24-1)
  command 'dll' from deb brickos (0.9.0.dfsg-12.2)
  command 'qdel' from deb gridengine-client (8.1.9+dfsg-9build2)
  command 'qdel' from deb slurm-wlm-torque (19.05.5-1)
  command 'delp' from deb fp-utils-3.0.4 (3.0.4+dfsg-23)

See 'snap info <snapname>' for additional versions.

hadoop@ubuntudev:~/Desktop/temp$ rmr temp.text

Command 'rmr' not found, did you mean:

  command 'amr' from deb acr (1.7.2-1)
  command 'rmt' from deb tar (1.30+dfsg-7ubuntu0.20.04.1)
  command 'rmt' from deb dump (0.4b46-6)
  command 'mr' from deb myrepos (1.20180726)
  command 'rmm' from deb mailutils-mh (1:3.7-2.1)
  command 'rmm' from deb mmh (0.4-2)
  command 'rmm' from deb nmh (1.7.1-6)
  command 'rar' from deb rar (2:5.5.0-1build1)
  command 'rm' from deb coreutils (8.30-3ubuntu2)
  command 'rmf' from deb mailutils-mh (1:3.7-2.1)
  command 'rmf' from deb mmh (0.4-2)
  command 'rmf' from deb nmh (1.7.1-6)
  command 'rr' from deb rr (5.3.0-2)
  command 'rme' from deb pvm-examples (3.4.6-2build2)

Try: sudo apt install <deb name>

hadoop@ubuntudev:~/Desktop/temp$ rmr temp.text

Command 'rmr' not found, did you mean:

  command 'rmm' from deb mailutils-mh (1:3.7-2.1)
  command 'rmm' from deb mmh (0.4-2)
  command 'rmm' from deb nmh (1.7.1-6)
  command 'rr' from deb rr (5.3.0-2)
  command 'rm' from deb coreutils (8.30-3ubuntu2)
  command 'rme' from deb pvm-examples (3.4.6-2build2)
  command 'mr' from deb myrepos (1.20180726)
  command 'rmf' from deb mailutils-mh (1:3.7-2.1)
  command 'rmf' from deb mmh (0.4-2)
  command 'rmf' from deb nmh (1.7.1-6)
  command 'amr' from deb acr (1.7.2-1)
  command 'rar' from deb rar (2:5.5.0-1build1)
  command 'rmt' from deb tar (1.30+dfsg-7ubuntu0.20.04.1)
  command 'rmt' from deb dump (0.4b46-6)

Try: sudo apt install <deb name>

hadoop@ubuntudev:~/Desktop/temp$ moveFromLocal ../Desktop/temp/temp.text /tempToDelete
moveFromLocal: command not found
hadoop@ubuntudev:~/Desktop/temp$ cd ~
hadoop@ubuntudev:~$ mkdir tempToDelete2
hadoop@ubuntudev:~$ cp tempToDelete tempToDelete1
cp: -r not specified; omitting directory 'tempToDelete'
hadoop@ubuntudev:~$ cp /tempToDelete /tempToDelete2
cp: cannot stat '/tempToDelete': No such file or directory
hadoop@ubuntudev:~$ cp tempToDelete tempToDelete2
cp: -r not specified; omitting directory 'tempToDelete'
hadoop@ubuntudev:~$ cd temp
bash: cd: temp: No such file or directory
hadoop@ubuntudev:~$ cd tempToDelete
hadoop@ubuntudev:~/tempToDelete$ ls
temp2.txt  temp3.txt  temp.txt
hadoop@ubuntudev:~/tempToDelete$ cd tempToDelete2
bash: cd: tempToDelete2: No such file or directory
hadoop@ubuntudev:~/tempToDelete$ mv temp.txt /tempToDelete2
mv: cannot move 'temp.txt' to '/tempToDelete2': Permission denied
hadoop@ubuntudev:~/tempToDelete$ sudo mv temp.txt /tempToDelete2
[sudo] password for hadoop: 
hadoop@ubuntudev:~/tempToDelete$ cd ~/tempToDelete2
hadoop@ubuntudev:~/tempToDelete2$ ls
hadoop@ubuntudev:~/tempToDelete2$ cd ..
hadoop@ubuntudev:~$ cd tempToDelte
bash: cd: tempToDelte: No such file or directory
hadoop@ubuntudev:~$ cd tempToDelete
hadoop@ubuntudev:~/tempToDelete$ ls
temp2.txt  temp3.txt
hadoop@ubuntudev:~/tempToDelete$ cd ..
hadoop@ubuntudev:~$ rmr tempToDelete2

Command 'rmr' not found, did you mean:

  command 'rmf' from deb mailutils-mh (1:3.7-2.1)
  command 'rmf' from deb mmh (0.4-2)
  command 'rmf' from deb nmh (1.7.1-6)
  command 'rm' from deb coreutils (8.30-3ubuntu2)
  command 'rmm' from deb mailutils-mh (1:3.7-2.1)
  command 'rmm' from deb mmh (0.4-2)
  command 'rmm' from deb nmh (1.7.1-6)
  command 'mr' from deb myrepos (1.20180726)
  command 'rar' from deb rar (2:5.5.0-1build1)
  command 'rmt' from deb tar (1.30+dfsg-7ubuntu0.20.04.1)
  command 'rmt' from deb dump (0.4b46-6)
  command 'amr' from deb acr (1.7.2-1)
  command 'rme' from deb pvm-examples (3.4.6-2build2)
  command 'rr' from deb rr (5.3.0-2)

Try: sudo apt install <deb name>

hadoop@ubuntudev:~$ du tempToDelete
4	tempToDelete
hadoop@ubuntudev:~$ dus tempToDelete

Command 'dus' not found, did you mean:

  command 'dub' from snap dub (1.19.0)
  command 'eus' from deb euslisp (9.26+dfsg-2)
  command 'bus' from deb atm-tools (1:2.5.1-4)
  command 'du' from deb coreutils (8.30-3ubuntu2)
  command 'duk' from deb duktape (2.5.0-1)
  command 'dms' from deb anacrolix-dms (1.1.0-1)
  command 'duc' from deb duc (1.4.3-6)
  command 'duc' from deb duc-nox (1.4.3-6)
  command 'dcs' from deb drbl (2.30.5-1)
  command 'dub' from deb dub (1.19.0-1build2)

See 'snap info <snapname>' for additional versions.

hadoop@ubuntudev:~$ stat tempToDelete
  File: tempToDelete
  Size: 4096      	Blocks: 8          IO Block: 4096   directory
Device: 805h/2053d	Inode: 802789      Links: 2
Access: (0775/drwxrwxr-x)  Uid: ( 1000/  hadoop)   Gid: ( 1000/  hadoop)
Access: 2021-03-12 04:52:51.909262846 -0800
Modify: 2021-03-12 04:52:00.596883086 -0800
Change: 2021-03-12 04:52:00.596883086 -0800
 Birth: -
hadoop@ubuntudev:~$ setrep -R 4/tempToDelete

Command 'setrep' not found, did you mean:

  command 'setreg' from deb mono-devel (6.8.0.105+dfsg-2)

Try: sudo apt install <deb name>

hadoop@ubuntudev:~$ 
